35 35
00 00 00 00 00 00 00 00 00 00 00 00 32 32 32 32 32 32 32 32 32 32 32 00 00 00 00 00 00 00 00 00 00 00 00
00 00 00 00 00 00 00 00 00 00 00 00 32 10 01 01 01 01 10 10 10 22 32 00 00 00 00 00 00 00 00 00 00 00 00
00 00 00 00 00 00 00 00 00 00 00 00 32 10 01 10 01 10 01 01 01 01 32 00 00 00 00 00 00 00 00 00 00 00 00
00 00 00 00 00 00 00 00 00 00 00 00 32 10 01 10 01 10 10 10 01 10 32 00 00 00 00 00 00 00 00 00 00 00 00
00 00 00 00 00 00 00 00 00 00 00 00 32 01 01 10 01 01 10 10 01 10 32 00 00 00 00 00 00 00 00 00 00 00 00
00 00 00 00 00 00 00 00 00 00 00 00 32 10 01 01 10 01 10 01 01 40 32 00 00 00 00 00 00 00 00 00 00 00 00
00 00 00 00 00 00 00 00 00 00 00 00 32 10 01 10 10 01 10 01 10 10 32 00 00 00 00 00 00 00 00 00 00 00 00
00 00 00 00 00 00 00 00 00 00 00 00 32 01 01 01 10 01 01 01 10 10 32 00 00 00 00 00 00 00 00 00 00 00 00
00 00 00 00 00 00 00 00 00 00 00 00 32 01 10 01 01 10 10 01 01 01 32 00 00 00 00 00 00 00 00 00 00 00 00
00 00 00 00 00 00 00 00 00 00 00 00 32 01 10 10 01 01 01 10 10 10 32 00 00 00 00 00 00 00 00 00 00 00 00
00 00 00 00 00 00 00 00 00 00 00 00 32 32 32 32 32 32 32 32 32 32 32 00 00 00 00 00 00 00 00 00 00 00 00
00 00 00 00 00 00 00 00 00 00 00 00 00 00 00 00 00 00 00 00 00 00 00 00 00 00 00 00 00 00 00 00 00 00 00
32 32 32 32 32 32 32 32 32 32 32 00 32 32 32 32 32 32 32 32 32 32 32 00 32 32 32 32 32 32 32 32 32 32 32
32 11 13 13 13 13 13 13 13 01 32 00 32 40 01 01 01 01 01 01 01 01 32 00 32 17 01 01 01 17 01 01 01 22 32
32 12 16 16 16 16 16 16 32 01 32 00 32 14 14 14 14 14 14 14 11 01 32 00 32 17 17 01 17 17 01 17 01 40 32
32 12 16 10 16 16 16 16 32 01 32 00 32 01 01 01 01 01 14 01 12 01 32 00 32 01 01 01 01 17 01 17 17 17 32
32 12 16 16 16 16 16 16 01 16 32 00 32 32 32 32 32 32 32 14 12 01 32 00 32 01 00 01 00 17 01 01 17 17 32
32 12 01 16 16 16 01 10 16 16 32 00 32 01 01 01 01 01 32 18 12 01 32 00 32 01 17 01 00 17 17 01 00 17 32
32 12 16 10 16 10 16 16 16 16 32 00 32 14 14 14 11 01 32 01 12 01 32 00 32 01 00 01 01 01 17 01 01 17 32
32 12 16 16 16 16 16 16 16 16 32 00 32 01 01 01 12 01 32 01 12 01 32 00 32 01 01 17 17 01 00 00 01 00 32
32 12 16 16 16 10 01 16 01 01 32 00 32 14 11 01 12 01 32 01 12 01 32 00 32 17 01 17 17 01 01 01 01 17 32
32 22 01 16 40 10 16 16 10 01 32 00 32 35 12 01 12 01 32 01 12 01 32 00 32 01 01 17 17 17 17 00 17 17 32
32 32 32 32 32 32 32 32 32 32 32 00 32 32 32 32 32 32 32 32 32 32 32 00 32 32 32 32 32 32 32 32 32 32 32
00 00 00 00 00 00 00 00 00 00 00 00 00 00 00 00 00 00 00 00 00 00 00 00 00 00 00 00 00 00 00 00 00 00 00
00 00 00 00 00 00 00 00 00 00 00 00 32 32 32 32 32 32 32 32 32 32 32 00 00 00 00 00 00 00 00 00 00 00 00
00 00 00 00 00 00 00 00 00 00 00 00 32 11 40 11 11 11 01 12 01 01 32 00 00 00 00 00 00 00 00 00 00 00 00
00 00 00 00 00 00 00 00 00 00 00 00 32 11 01 01 01 01 01 12 01 01 32 00 00 00 00 00 00 00 00 00 00 00 00
00 00 00 00 00 00 00 00 00 00 00 00 32 11 11 11 01 12 01 01 01 11 32 00 00 00 00 00 00 00 00 00 00 00 00
00 00 00 00 00 00 00 00 00 00 00 00 32 11 01 01 01 11 14 14 11 11 32 00 00 00 00 00 32 32 32 32 32 32 32
00 00 00 00 00 00 00 00 00 00 00 00 32 11 14 12 01 01 01 01 11 11 32 00 00 00 00 00 32 40 01 01 01 40 32
00 00 00 00 00 00 00 00 00 00 00 00 32 11 11 11 14 11 01 11 11 11 32 00 00 00 00 00 32 01 01 40 01 01 32
00 00 00 00 00 00 00 00 00 00 00 00 32 11 01 01 01 12 01 01 01 01 32 00 00 00 00 00 32 01 01 01 01 01 32
00 00 00 00 00 00 00 00 00 00 00 00 32 11 01 11 01 01 01 11 01 11 32 00 00 00 00 00 32 01 01 34 01 01 32
00 00 00 00 00 00 00 00 00 00 00 00 32 22 01 11 11 11 11 11 11 11 32 00 00 00 00 00 32 40 01 01 01 40 32
00 00 00 00 00 00 00 00 00 00 00 00 32 32 32 32 32 32 32 32 32 32 32 00 00 00 00 00 32 32 32 32 32 32 32
05 10
08     
01 21
13 14  
14 14
15 14
16 14
17 14
18 14
18 15
19 14
03
21 01
13 20
14 20
14 21
09
13 33
20 14
20 15
20 16
19 16
20 17
20 18
20 19
20 20
20 21
11
19 17
13 16
14 16
15 16
16 16
17 16
18 16
18 17
18 18
18 19
18 20
18 21
07
33 13
13 18
14 18
15 18
16 18
16 19
16 20
16 21
01
29 29
13 09
01
33 29
09 13
01
29 33
21 25
01
33 33
25 21
01
31 30
21 13
01
33 14
31 31
01
31 05
31 31
01
13 13
31 31
01
14 25
31 31
01
04 21
31 31