29   39
00   00   00   00   00   00   00   00   00   00   00   32   32   32   32   32   32   32   00   00   00   00   00   00   00   00   00   00   00
00   00   00   00   00   00   00   00   00   00   00   32   01   01   01   01   35   32   00   00   00   00   00   00   00   00   00   00   00
00   00   00   00   00   00   00   00   00   00   00   32   01   01   01   01   01   32   00   00   00   00   00   00   00   00   00   00   00
00   00   00   00   00   00   00   00   00   00   00   32   11   11   11   11   11   32   00   00   00   00   00   00   00   00   00   00   00
00   00   00   00   00   00   00   00   00   00   00   32   11   11   11   11   11   32   00   00   00   00   00   00   00   00   00   00   00
00   00   00   00   00   00   00   00   00   00   00   32   11   11   11   11   11   32   00   00   00   00   00   00   00   00   00   00   00
00   00   00   00   00   00   00   00   00   00   00   32   01   01   10   01   01   32   00   00   00   00   00   00   00   00   00   00   00
00   00   00   00   00   00   00   00   00   00   00   32   01   01   01   01   01   32   00   00   00   00   00   00   00   00   00   00   00
00   00   00   00   00   00   00   00   00   00   00   32   01   01   01   01   01   32   00   00   00   00   00   00   00   00   00   00   00
00   00   00   00   00   00   00   00   00   00   00   32   01   01   01   01   01   32   00   00   00   00   00   00   00   00   00   00   00
32   32   32   32   32   32   32   32   32   32   32   32   32   32   32   01   01   32   32   32   32   32   32   32   32   32   32   32   32
32   01   01   01   32   01   01   01   01   01   01   32   01   01   01   01   01   32   01   01   01   01   01   01   01   01   01   01   32
32   01   01   01   32   01   01   01   01   01   01   32   01   01   32   32   32   32   01   01   01   01   01   01   01   01   01   01   32
32   01   01   01   32   01   01   01   01   01   01   32   01   01   01   01   01   33   01   01   01   01   01   01   01   01   01   01   32
32   01   01   01   01   01   32   01   01   01   01   32   32   32   32   01   01   32   11   11   11   11   32   01   01   01   01   01   32
32   32   32   32   01   01   32   01   01   01   01   32   01   01   01   01   01   32   01   01   01   01   32   01   01   32   32   32   32
32   01   01   01   01   01   32   01   01   20   01   32   01   01   32   32   32   32   20   01   01   01   32   01   01   01   01   01   32
32   01   01   01   32   32   32   32   33   32   32   32   01   01   01   01   01   32   32   32   32   32   32   32   32   01   01   01   32
32   01   01   01   01   01   01   09   01   09   01   09   32   32   32   01   01   01   32   01   01   01   32   01   01   01   01   01   32
32   01   01   01   01   01   01   09   01   09   01   09   01   01   01   01   01   01   32   01   01   01   32   01   01   32   01   01   32
32   01   01   01   01   32   01   09   01   09   01   09   01   01   01   01   01   01   01   01   32   01   01   01   01   32   01   01   32
32   01   01   01   01   32   01   09   01   09   01   09   01   01   01   01   01   01   01   01   32   01   01   01   01   32   01   01   32
32   32   32   32   32   32   32   32   33   32   32   32   01   01   01   01   01   32   32   32   32   32   32   33   32   32   32   32   32
00   00   32   01   02   02   02   02   02   02   01   32   01   01   01   01   01   32   10   01   16   16   16   01   01   01   32   00   00
00   00   32   01   02   03   03   04   03   02   02   32   01   01   01   01   01   32   01   16   16   16   16   01   01   01   32   00   00
00   00   32   01   02   03   32   04   04   03   03   32   01   01   01   01   01   32   16   16   16   16   32   01   01   01   32   00   00
00   00   32   01   02   02   32   04   03   02   02   33   01   01   01   01   01   33   16   16   16   10   32   01   01   01   32   00   00
00   00   32   01   02   02   32   01   01   20   01   32   01   01   01   01   01   32   10   16   20   01   32   01   01   01   32   00   00
00   00   32   01   01   01   32   32   32   32   32   32   01   01   01   01   01   32   32   32   32   32   32   01   01   01   32   00   00
00   00   32   01   01   01   01   01   01   01   01   01   01   01   01   01   01   01   01   01   01   01   01   01   01   01   32   00   00
00   00   32   01   01   01   01   01   01   01   01   01   01   01   01   01   01   01   01   01   01   01   01   01   01   01   32   00   00
00   00   32   01   01   01   01   01   01   01   01   01   01   01   01   01   01   01   01   01   01   01   01   01   01   01   32   00   00
00   00   32   01   01   01   01   01   01   01   01   01   01   01   01   01   01   01   01   01   01   01   01   01   01   01   32   00   00
00   00   32   32   32   32   32   32   32   32   32   32   32   32   38   32   32   32   32   32   32   32   32   32   32   32   32   00   00
00   00   00   00   00   00   00   00   00   00   00   32   01   01   01   01   01   32   00   00   00   00   00   00   00   00   00   00   00
00   00   00   00   00   00   00   00   00   00   00   32   01   01   01   01   01   32   00   00   00   00   00   00   00   00   00   00   00
00   00   00   00   00   00   00   00   00   00   00   32   01   01   01   01   01   32   00   00   00   00   00   00   00   00   00   00   00
00   00   00   00   00   00   00   00   00   00   00   32   34   01   01   01   01   32   00   00   00   00   00   00   00   00   00   00   00
00   00   00   00   00   00   00   00   00   00   00   32   32   32   32   32   32   32   00   00   00   00   00   00   00   00   00   00   00
04   00