23 15 01 128
1 1 1 1 1 1 1 1 1 1 1
32 32 32 32 32 32 32 32 32 32 32 32 32 32 32 32 32 32 32 32 32 32 32
32 00 00 00 00 00 01 01 01 11 01 01 01 11 00 00 00 00 00 00 00 00 32
32 00 00 00 00 10 16 00 00 16 16 16 16 16 00 00 00 00 00 00 00 00 32
32 00 00 00 00 00 01 00 00 10 11 01 11 10 00 00 00 01 16 01 16 01 32
32 00 00 00 00 01 01 00 00 00 00 01 00 00 00 00 00 01 11 11 11 10 32
32 34 01 01 01 01 16 00 00 00 00 01 00 00 00 00 00 01 11 11 11 01 32
32 00 00 00 00 00 16 00 00 00 00 01 16 01 16 01 01 01 11 11 11 01 32
32 00 00 00 00 00 11 00 00 00 00 00 16 00 16 00 00 00 00 00 00 16 32
32 00 00 00 00 00 00 00 00 00 00 00 10 00 11 00 00 00 00 00 00 01 32
32 35 01 01 01 01 01 00 00 00 00 00 00 00 00 00 00 00 00 00 00 01 32
32 00 00 00 11 16 01 01 00 00 00 00 01 01 16 01 01 01 01 01 10 01 32
32 00 00 00 11 16 00 01 11 11 01 01 01 11 10 01 01 16 11 11 11 00 32
32 00 00 00 00 10 00 01 11 16 01 00 00 00 00 00 00 11 11 11 11 00 32
32 00 00 00 00 00 00 01 01 01 01 00 00 00 00 00 00 00 00 00 00 00 32
32 32 32 32 32 32 32 32 32 32 32 32 32 32 32 32 32 32 32 32 32 32 32
