35 35                                 
00 00 00 00 00 00 00 00 00 00 00 00 32 32 32 32 32 32 32 32 32 32 32 00 00 00 00 00 00 00 00 00 00 00 00
00 00 00 00 00 00 00 00 00 00 00 00 32 10 01 01 01 01 10 10 10 22 32 00 00 00 00 00 00 00 00 00 00 00 00
00 00 00 00 00 00 00 00 00 00 00 00 32 10 01 10 01 10 01 01 01 01 32 00 00 00 00 00 00 00 00 00 00 00 00
00 00 00 00 00 00 00 00 00 00 00 00 32 10 01 10 01 10 10 10 01 10 32 00 00 00 00 00 00 00 00 00 00 00 00
00 00 00 00 00 00 00 00 00 00 00 00 32 01 01 10 01 01 10 10 01 10 32 00 00 00 00 00 00 00 00 00 00 00 00
00 00 00 00 00 00 00 00 00 00 00 00 32 10 01 01 10 01 10 01 01 01 32 00 00 00 00 00 00 00 00 00 00 00 00
00 00 00 00 00 00 00 00 00 00 00 00 32 10 01 10 10 01 10 01 10 10 32 00 00 00 00 00 00 00 00 00 00 00 00
00 00 00 00 00 00 00 00 00 00 00 00 32 01 01 01 10 01 01 01 10 10 32 00 00 00 00 00 00 00 00 00 00 00 00
00 00 00 00 00 00 00 00 00 00 00 00 32 01 10 01 01 10 10 01 01 01 32 00 00 00 00 00 00 00 00 00 00 00 00
00 00 00 00 00 00 00 00 00 00 00 00 32 34 10 10 01 01 01 10 10 10 32 00 00 00 00 00 00 00 00 00 00 00 00
00 00 00 00 00 00 00 00 00 00 00 00 32 32 32 32 32 32 32 32 32 32 32 00 00 00 00 00 00 00 00 00 00 00 00
00 00 00 00 00 00 00 00 00 00 00 00 00 00 00 00 00 00 00 00 00 00 00 00 00 00 00 00 00 00 00 00 00 00 00
32 32 32 32 32 32 32 32 32 32 32 00 32 32 32 32 32 32 32 32 32 32 32 00 32 32 32 32 32 32 32 32 32 32 32
32 11 13 13 13 13 13 13 13 34 32 00 32 01 01 01 01 01 01 01 01 34 32 00 32 17 01 01 01 17 01 01 01 22 32
32 12 16 16 16 16 16 16 32 01 32 00 32 11 11 11 11 11 11 11 11 01 32 00 32 17 17 01 17 17 01 17 01 01 32
32 12 16 10 16 16 16 16 32 01 32 00 32 01 01 01 01 01 01 01 11 01 32 00 32 01 01 01 01 17 01 17 17 17 32
32 12 16 16 16 16 16 16 01 16 32 00 32 32 32 32 32 32 32 01 11 01 32 00 32 01 00 01 00 17 01 01 17 17 32
32 12 01 16 16 16 01 10 16 16 32 00 32 01 01 01 01 01 32 18 11 01 32 00 32 01 17 01 00 17 17 01 00 17 32
32 12 16 10 16 10 16 16 16 16 32 00 32 11 11 11 11 01 32 01 11 01 32 00 32 01 00 01 01 01 17 01 01 17 32
32 12 16 16 16 16 16 16 16 16 32 00 32 01 01 01 11 01 32 01 11 01 32 00 32 01 01 17 17 01 00 00 01 00 32
32 12 16 16 16 10 01 16 01 01 32 00 32 11 11 01 11 01 32 01 11 01 32 00 32 17 01 17 17 01 01 01 01 17 32
32 22 01 16 16 10 16 16 10 01 32 00 32 35 11 01 11 01 32 01 11 01 32 00 32 34 01 17 17 17 17 00 17 17 32
32 32 32 32 32 32 32 32 32 32 32 00 32 32 32 32 32 32 32 32 32 32 32 00 32 32 32 32 32 32 32 32 32 32 32
00 00 00 00 00 00 00 00 00 00 00 00 00 00 00 00 00 00 00 00 00 00 00 00 00 00 00 00 00 00 00 00 00 00 00
00 00 00 00 00 00 00 00 00 00 00 00 32 32 32 32 32 32 32 32 32 32 32 00 00 00 00 00 00 00 00 00 00 00 00
00 00 00 00 00 00 00 00 00 00 00 00 32 11 01 11 11 11 01 11 01 34 32 00 00 00 00 00 00 00 00 00 00 00 00
00 00 00 00 00 00 00 00 00 00 00 00 32 11 01 01 01 01 01 11 01 01 32 00 00 00 00 00 00 00 00 00 00 00 00
00 00 00 00 00 00 00 00 00 00 00 00 32 11 11 11 01 11 01 01 01 11 32 00 00 00 00 00 00 00 00 00 00 00 00
00 00 00 00 00 00 00 00 00 00 00 00 32 11 01 01 01 11 11 11 11 11 32 00 00 00 00 00 32 32 32 32 32 32 32
00 00 00 00 00 00 00 00 00 00 00 00 32 11 11 11 01 01 01 01 11 11 32 00 00 00 00 00 32 34 01 01 01 34 32
00 00 00 00 00 00 00 00 00 00 00 00 32 11 11 11 11 11 01 11 11 11 32 00 00 00 00 00 32 01 01 34 01 01 32
00 00 00 00 00 00 00 00 00 00 00 00 32 11 01 01 01 11 01 01 01 01 32 00 00 00 00 00 32 01 01 01 01 01 32
00 00 00 00 00 00 00 00 00 00 00 00 32 11 01 11 01 01 01 11 01 11 32 00 00 00 00 00 32 01 01 34 01 01 32
00 00 00 00 00 00 00 00 00 00 00 00 32 22 01 11 11 11 11 11 11 11 32 00 00 00 00 00 32 34 01 01 01 34 32
00 00 00 00 00 00 00 00 00 00 00 00 32 32 32 32 32 32 32 32 32 32 32 00 00 00 00 00 32 32 32 32 32 32 32