36 21
00 00 00 00 00 00 00 00 00 00 00 00 00 00 00 00 00 00 00 32 32 32 32 32 32 32 00 00 00 00 00 00 00 00 00 00
00 00 00 00 00 00 00 00 00 00 00 00 00 00 00 00 00 00 00 32 00 00 00 00 00 32 00 00 00 00 00 00 00 00 00 00
00 00 00 00 00 00 00 00 00 00 00 00 00 00 00 00 00 00 00 32 00 34 01 01 00 32 00 00 00 00 00 00 00 00 00 00
00 00 00 00 00 00 00 00 00 00 00 00 00 00 00 00 00 00 00 32 00 01 01 01 00 32 00 00 00 00 00 00 00 00 00 00
32 32 32 32 32 32 32 32 32 32 32 32 32 32 32 32 32 32 32 32 32 33 33 37 32 32 32 32 32 32 32 32 32 32 32 32
32 00 00 00 00 00 00 00 00 00 00 00 00 00 00 00 00 00 00 00 01 01 01 01 01 00 00 00 00 00 00 00 00 00 00 32
32 00 01 01 01 01 01 01 01 01 01 01 01 01 01 02 33 33 02 01 01 01 01 01 01 01 01 01 01 01 01 01 01 01 00 32
32 00 01 01 01 01 01 01 01 01 01 01 01 01 01 02 33 33 02 01 01 01 01 01 01 01 01 01 01 01 01 01 01 01 00 32
32 00 01 01 01 01 01 01 01 01 01 01 01 01 01 01 01 01 01 01 01 01 01 01 01 01 01 01 01 01 01 01 01 01 00 32
32 00 01 01 01 00 00 00 00 00 00 01 01 01 01 01 01 01 01 01 01 01 01 01 01 32 32 32 32 32 00 01 01 01 00 32
32 00 01 01 01 32 32 32 32 32 00 01 01 01 01 32 32 32 32 32 00 01 01 01 01 32 32 32 32 32 00 02 02 02 00 32
32 00 01 01 01 32 32 32 32 32 00 01 01 01 01 32 32 32 32 32 00 01 01 01 01 32 32 32 32 32 00 03 03 03 00 32
32 00 01 01 01 32 32 32 32 32 00 01 01 01 01 32 32 32 32 32 00 01 01 01 01 32 32 32 32 32 00 03 03 03 00 32
32 00 01 01 01 32 32 32 32 32 00 01 01 01 01 32 32 32 32 32 00 01 01 01 01 32 32 32 32 32 00 02 03 03 00 32
32 00 01 01 01 00 00 00 00 00 00 01 01 01 01 00 00 00 00 00 00 01 01 02 01 00 00 00 00 00 00 03 03 03 00 32
32 00 01 01 01 02 02 02 02 03 01 01 01 01 01 01 01 01 01 01 01 01 01 03 03 00 00 00 00 00 00 00 00 00 00 32
32 00 01 01 01 02 02 03 03 10 03 01 01 01 01 01 01 01 01 01 01 01 17 17 16 16 16 16 16 10 10 16 16 16 35 32
32 00 01 01 01 02 02 03 03 03 02 01 01 01 01 01 01 01 01 01 01 01 17 17 16 16 16 16 16 16 16 16 16 16 35 32
32 00 01 01 01 02 02 02 02 03 03 01 01 01 01 01 01 01 01 01 01 01 02 03 00 00 00 00 00 00 00 00 00 00 00 32
32 00 00 00 00 00 00 00 00 00 00 00 00 00 00 00 00 00 00 00 00 00 00 00 00 00 00 00 00 00 00 00 00 00 00 32
32 32 32 32 32 32 32 32 32 32 32 32 32 32 32 32 32 32 32 32 32 32 32 32 32 32 32 32 32 32 32 32 32 32 32 32