21 08 03 128
1 1 1 1 1 1 1 1 1 1 1
32 32 32 32 32 32 32 32 32 32 32 32 32 32 32 32 32 32 32 32 32
32 01 11 01 01 32 32 11 01 11 01 11 01 01 01 11 01 01 01 34 32
32 01 11 11 11 11 11 11 11 11 11 11 11 11 11 11 11 33 00 00 32
32 11 11 11 01 11 11 01 01 01 11 11 11 11 11 01 01 00 00 00 32
32 01 01 33 01 11 11 01 11 11 01 01 01 01 01 01 01 01 00 00 32
32 35 11 11 01 01 01 01 11 11 33 00 00 00 00 00 00 00 00 00 32
32 01 33 01 01 01 01 01 01 01 01 00 00 00 00 00 00 00 00 00 32
32 32 32 32 32 32 32 32 32 32 32 32 32 32 32 32 32 32 32 32 32
00 00