23 29 00 128
1 1 1 1 1 1 1 1 1 1 1
17 17 17 17 17 17 17 17 17 17 17 17 17 17 17 17 17 17 17 17 17 17 17
17 17 17 17 17 17 17 17 17 17 17 17 17 35 17 17 17 17 17 17 17 17 17
17 17 17 17 17 17 17 17 17 17 17 17 17 01 17 17 17 17 17 17 17 17 17
17 17 17 17 17 17 17 17 17 17 17 17 17 01 17 17 17 17 17 17 17 17 17
17 17 17 17 17 17 17 17 17 17 17 17 17 32 17 17 17 17 17 17 17 17 17
17 01 01 01 01 01 01 10 01 10 01 01 01 01 17 17 17 17 17 17 17 17 17
17 01 17 17 17 17 17 17 17 17 17 17 17 01 01 01 01 01 17 17 17 17 17
17 01 17 17 17 17 17 17 17 17 17 17 17 11 17 17 17 07 17 17 17 17 17
17 01 17 17 17 17 17 17 17 17 17 17 17 01 17 17 17 01 17 17 17 17 17
17 01 17 17 17 17 17 17 17 17 17 17 17 01 17 17 17 07 17 17 17 17 17
17 01 17 17 17 17 17 17 17 17 17 17 17 08 17 17 17 01 01 01 01 01 17
17 01 17 17 17 17 17 17 17 17 17 17 17 01 17 17 17 01 17 17 17 01 17
17 01 01 01 01 01 01 01 01 17 17 17 17 08 17 17 17 01 17 17 17 01 17
17 11 17 17 17 17 17 17 10 17 17 17 17 01 17 17 17 01 17 17 17 01 17
17 01 17 17 17 17 17 17 01 17 17 17 17 01 17 17 17 01 17 17 17 01 17
17 10 17 17 17 17 17 17 07 17 17 17 17 01 17 17 17 01 17 17 17 01 17
17 10 17 17 17 17 17 17 01 01 01 01 01 34 01 01 01 01 06 01 06 01 17
17 01 17 17 17 17 17 17 01 17 17 17 17 01 17 17 17 17 17 17 17 17 17
17 10 17 17 17 17 17 17 01 17 17 17 17 01 17 17 17 17 17 17 17 17 17
17 10 17 17 17 17 17 17 10 17 17 17 17 01 17 17 17 17 17 17 17 17 17
17 01 17 17 17 17 17 17 01 17 17 17 17 01 17 17 17 17 17 17 17 17 17
17 01 01 01 01 01 01 01 01 17 17 17 17 10 17 17 17 17 17 17 17 17 17
17 01 17 17 17 17 17 17 01 17 17 17 17 10 17 17 17 17 17 17 17 17 17
17 01 17 17 01 01 01 01 01 17 17 17 17 01 17 17 17 17 17 17 17 17 17
17 01 17 17 01 17 17 17 01 01 01 01 01 01 01 17 17 17 17 17 17 17 17
17 01 17 17 01 01 17 17 17 17 17 17 17 17 17 17 17 17 17 17 17 17 17
17 01 17 17 01 17 17 17 17 17 17 17 17 17 17 17 17 17 17 17 17 17 17
17 01 21 01 01 17 17 17 17 17 17 17 17 17 17 17 17 17 17 17 17 17 17
17 17 17 17 17 17 17 17 17 17 17 17 17 17 17 17 17 17 17 17 17 17 17
01 00
01
02 27
13 04