31 17 01 128
1 1 1 1 1 1 1 1 1 1 1
32 32 32 32 32 32 32 32 32 32 32 32 32 32 32 32 32 32 32 32 32 32 32 32 32 32 32 00 00 00 00
32 19 01 10 01 10 01 01 10 01 00 00 00 00 00 00 10 00 00 00 00 00 00 00 00 00 32 00 00 00 00
32 00 00 00 01 01 00 00 00 01 00 00 00 00 00 00 01 00 00 00 00 00 00 00 00 00 32 32 32 32 32
32 00 00 00 10 10 00 00 00 10 01 00 00 01 00 00 01 01 10 01 10 00 00 00 00 01 32 01 01 35 32
32 00 00 00 01 01 10 01 00 01 01 32 10 01 01 01 01 01 10 10 01 00 00 00 00 10 32 32 32 32 32
32 00 00 00 01 10 00 10 00 00 10 00 00 00 00 00 01 01 01 01 10 01 01 10 01 01 32 00 00 00 00
32 00 00 00 10 01 00 10 00 00 01 32 32 32 32 32 32 32 32 32 32 32 32 32 32 32 32 00 00 00 00
32 00 00 00 01 01 10 01 00 00 01 32 00 00 00 00 00 00 00 00 00 00 00 00 00 00 00 00 00 00 00
32 00 00 00 00 00 00 00 00 00 10 32 00 00 00 00 00 00 00 00 00 00 00 00 00 00 00 00 00 00 00
32 00 00 00 00 00 00 00 00 00 01 32 00 00 00 00 00 00 00 00 00 00 00 00 00 00 00 00 00 00 00
32 34 01 01 01 01 10 01 10 10 01 32 00 00 00 00 00 00 00 00 00 00 00 00 00 00 00 00 00 00 00
32 00 00 00 00 10 00 01 00 00 01 32 00 00 00 00 00 00 00 00 00 00 00 00 00 00 00 00 00 00 00
32 00 00 00 00 10 00 01 10 01 01 32 00 00 00 00 00 00 00 00 00 00 00 00 00 00 00 00 00 00 00
32 00 00 00 00 10 00 00 00 00 01 32 00 00 00 00 00 00 00 00 00 00 00 00 00 00 00 00 00 00 00
32 00 00 00 00 10 00 00 00 01 10 32 00 00 00 00 00 00 00 00 00 00 00 00 00 00 00 00 00 00 00
32 18 01 01 01 10 01 01 10 01 01 32 00 00 00 00 00 00 00 00 00 00 00 00 00 00 00 00 00 00 00
32 32 32 32 32 32 32 32 32 32 32 32 00 00 00 00 00 00 00 00 00 00 00 00 00 00 00 00 00 00 00
02 00
01
01 15
11 04
01
01 01
26 03
