31 17 01 364
1 1 1 1 0 0 0 1 1 1 1
00 00 00 00 00 00 00 00 00 00 00 00 00 00 00 00 00 00 00 00 00 00 00 00 00 00 00 00 00 00 00
00 19 01 10 01 10 01 01 10 01 00 00 00 00 00 00 10 00 00 00 00 00 00 00 00 00 00 00 00 00 00
00 00 00 00 01 01 00 00 00 01 00 00 00 00 00 00 01 00 00 00 00 00 00 00 00 00 00 00 00 00 00
00 00 00 00 10 10 00 00 00 10 01 00 00 01 00 00 01 01 10 01 10 00 00 00 00 01 32 01 01 35 00
00 00 00 00 01 01 10 01 00 01 01 32 10 01 01 01 01 01 10 10 01 00 00 00 00 10 00 00 00 00 00
00 00 00 00 01 10 00 10 00 00 10 00 00 00 00 00 01 01 01 01 10 01 01 10 01 01 00 00 00 00 00
00 00 00 00 10 01 00 10 00 00 01 00 00 00 00 00 00 00 00 00 00 00 00 00 00 00 00 00 00 00 00
00 00 00 00 01 01 10 01 00 00 01 00 00 00 00 00 00 00 00 00 00 00 00 00 00 00 00 00 00 00 00
00 00 00 00 00 00 00 00 00 00 10 00 00 00 00 00 00 00 00 00 00 00 00 00 00 00 00 00 00 00 00
00 00 00 00 00 00 00 00 00 00 01 00 00 00 00 00 00 00 00 00 00 00 00 00 00 00 00 00 00 00 00
00 34 01 01 01 01 10 01 10 10 01 00 00 00 00 00 00 00 00 00 00 00 00 00 00 00 00 00 00 00 00
00 00 00 00 00 10 00 01 00 00 01 00 00 00 00 00 00 00 00 00 00 00 00 00 00 00 00 00 00 00 00
00 00 00 00 00 10 00 01 10 01 01 00 00 00 00 00 00 00 00 00 00 00 00 00 00 00 00 00 00 00 00
00 00 00 00 00 10 00 00 00 00 01 00 00 00 00 00 00 00 00 00 00 00 00 00 00 00 00 00 00 00 00
00 00 00 00 00 10 00 00 00 01 10 00 00 00 00 00 00 00 00 00 00 00 00 00 00 00 00 00 00 00 00
00 18 01 01 01 10 01 01 10 01 01 00 00 00 00 00 00 00 00 00 00 00 00 00 00 00 00 00 00 00 00
00 00 00 00 00 00 00 00 00 00 00 00 00 00 00 00 00 00 00 00 00 00 00 00 00 00 00 00 00 00 00
02 00
01
01 15
11 04
01
01 01
26 03
