20 17 01 1024
1 1 1 1 1 1 1 1 1 1 1
00 00 00 00 00 00 00 00 00 00 00 00 00 00 00 00 00 00 00 00
00 01 01 01 01 35 00 00 00 00 00 00 00 00 00 00 00 00 00 00
00 01 00 00 00 00 00 00 00 34 01 01 01 00 00 00 00 00 00 00
00 10 00 00 00 00 00 00 00 01 00 00 01 00 00 00 00 00 00 00
00 01 00 00 00 00 00 00 00 01 00 00 01 00 00 00 00 00 00 00
00 01 00 00 00 00 00 00 00 01 01 01 01 01 01 01 01 10 01 00
00 01 00 00 00 00 00 00 00 33 00 00 00 00 00 00 00 00 01 00
00 01 00 00 00 00 00 00 00 01 00 00 00 00 00 00 00 00 01 00
00 01 00 00 00 00 00 00 00 01 00 00 00 00 00 00 00 00 01 00
00 01 01 01 01 01 10 01 33 01 01 01 01 00 00 00 00 00 01 00
00 01 00 00 00 01 00 00 00 00 00 00 33 00 00 00 00 00 11 00
00 01 00 00 00 01 00 00 00 00 00 00 01 00 00 00 00 00 01 00
00 01 00 00 00 01 00 00 00 00 00 00 01 01 01 01 01 01 01 00
00 01 00 00 00 11 00 00 00 00 00 00 00 00 01 00 00 00 01 00
00 01 00 00 00 11 00 00 00 00 00 00 00 00 01 00 00 00 01 00
00 01 01 01 01 01 01 01 01 01 01 01 01 01 01 01 01 01 01 00
00 00 00 00 00 00 00 00 00 00 00 00 00 00 00 00 00 00 00 00
00 00