26 21 01 140
1 1 1 1 1 1 1 1 1 1 1
00 00 00 00 00 00 00 00 00 00 00 00 00 00 00 00 00 00 00 00 00 00 00 00 00 00
00 00 00 00 00 00 00 00 00 00 00 00 00 00 00 00 00 00 00 00 01 01 01 01 01 00
00 00 00 00 00 00 00 00 00 00 00 00 00 00 00 00 00 00 00 00 34 01 01 01 01 00
00 00 00 00 00 00 00 00 00 00 00 00 00 00 00 00 00 00 00 00 01 01 01 01 01 00
00 00 00 00 00 00 00 00 00 00 00 00 00 00 00 00 00 00 00 00 00 33 33 37 00 00
00 12 01 01 01 01 01 01 01 01 01 01 01 01 01 01 33 33 01 01 01 01 01 01 15 00
00 12 01 01 01 01 01 01 01 01 01 01 01 01 01 02 33 33 02 01 01 01 01 01 15 00
00 12 01 01 01 01 01 01 01 01 01 01 01 01 01 02 33 33 02 01 01 01 01 01 15 00
00 12 01 01 01 01 01 01 01 01 01 01 01 01 01 01 33 33 01 01 01 01 01 01 15 00
00 12 01 01 01 01 01 01 01 20 01 01 01 01 01 01 33 33 01 01 01 01 01 01 15 00
00 12 01 01 01 15 10 10 10 10 12 01 01 01 15 10 10 10 10 10 12 02 02 02 15 00
00 12 01 01 01 15 10 10 10 10 12 01 01 01 15 10 10 10 10 10 12 03 03 03 15 00
00 12 01 01 01 15 10 10 10 10 12 01 01 01 15 10 10 10 10 10 12 03 03 03 15 00
00 12 01 01 01 15 10 10 10 10 12 01 01 03 15 10 10 10 10 10 12 02 04 04 15 00
00 12 01 01 01 01 01 01 01 01 01 01 03 02 03 01 01 01 01 01 01 03 03 02 15 00
00 12 01 01 01 02 02 02 02 03 01 01 01 03 03 32 32 32 32 32 32 32 32 32 32 00
00 12 01 01 01 02 02 03 03 10 03 01 17 17 16 16 16 16 32 10 10 16 16 16 35 00
00 12 01 01 01 02 02 03 03 03 02 01 17 17 16 16 16 16 32 16 16 16 16 16 16 00
00 12 01 01 01 02 02 02 02 03 03 01 02 03 32 32 32 32 32 32 32 32 32 32 32 00
00 12 01 01 01 01 01 01 01 01 01 01 01 01 01 01 01 01 01 01 01 01 01 01 01 00
00 00 00 00 00 00 00 00 00 00 00 00 00 00 00 00 00 00 00 00 00 00 00 00 00 00
01 00
02
09 09
28 16
28 17