11 17 2 1024
1 1 1 1 1 1 1 1 1 1 1
11 01 01 01 11 01 01 01 01 11 01
01 01 01 01 01 01 01 01 01 21 01
01 01 01 01 01 01 01 01 01 01 01
01 03 01 08 01 13 01 17 01 22 01
01 01 01 01 01 01 01 01 01 01 01
01 04 01 09 01 14 05 18 01 23 01
01 01 01 01 11 01 05 01 01 01 01
01 05 01 10 01 15 04 19 01 24 01
01 01 01 01 01 01 03 27 01 01 01
01 06 01 11 01 15 02 26 01 25 01
01 01 01 01 01 01 01 25 01 01 01
01 26 01 27 11 28 01 24 01 30 01
01 01 01 01 01 01 01 22 01 01 01
01 31 01 32 01 33 01 34 01 35 01
01 01 01 01 01 01 01 01 01 01 01
01 36 01 37 01 38 01 01 01 40 01
01 01 01 01 11 01 01 01 01 01 01
01 00
12
07 12
00 00
04 00
09 00
05 03
04 06
03 09
04 11
04 16
01 15
03 15
05 15
07 15