11 17 0
01 01 01 01 01 01 01 01 01 01 01
01 02 01 07 01 12 01 16 01 21 01
01 01 01 01 01 01 01 01 01 01 01
01 03 01 08 01 13 01 17 01 22 01
01 01 01 01 01 01 01 01 01 01 01
01 04 01 09 01 14 01 18 01 23 01
01 01 01 01 01 01 01 01 01 01 01
01 05 01 10 01 15 01 19 01 24 01
01 01 01 01 01 01 01 01 01 01 01
01 06 01 11 01 15 01 20 01 25 01
01 01 01 01 01 01 01 01 01 01 01
01 26 01 27 01 28 01 29 01 30 01
01 01 01 01 01 01 01 01 01 01 01
01 31 01 32 01 33 01 34 01 35 01
01 01 01 01 01 01 01 01 01 01 01
01 36 01 37 01 38 01 39 01 40 01
01 01 01 01 01 01 01 01 01 01 01
00 00
