09 06 03 44
1 0 1 1 0 1 0 0 0 1 1
03 02 03 05 04 03 02 01 35
03 01 02 04 05 05 05 05 05
04 01 01 03 03 04 02 03 02
05 04 03 02 05 04 03 04 03
04 03 02 03 04 05 04 03 02
03 03 02 01 01 01 01 01 34
00 00