30 27 0
00 00 00 00 00 00 00 00 00 00 00 32 32 32 32 32 32 32 00 00 00 00 00 00 00 00 00 00 00 00
00 00 00 00 00 00 00 00 00 00 00 32 01 16 10 01 21 32 00 00 00 00 00 00 00 00 00 00 00 00
00 00 00 00 00 00 00 00 00 00 00 32 01 16 16 16 16 32 00 00 00 00 00 00 00 00 00 00 00 00
00 00 00 00 00 00 00 00 00 00 00 32 01 16 16 10 10 32 00 00 00 00 00 00 00 00 00 00 00 00
00 00 00 00 00 00 00 00 00 00 00 32 01 01 01 01 01 32 00 00 00 00 00 00 00 00 00 00 00 00
00 00 00 00 00 00 32 32 32 32 32 32 01 01 01 01 01 32 32 32 32 32 32 32 00 00 00 00 00 00
00 00 00 00 00 00 32 35 11 13 13 32 01 01 01 01 01 32 01 01 01 01 01 32 00 00 00 00 00 00
00 00 00 00 00 00 32 11 11 01 01 32 01 01 01 01 01 39 01 01 01 01 01 32 00 00 00 00 00 00
00 00 00 00 00 00 32 12 01 01 01 32 01 01 01 01 01 32 01 01 01 01 01 32 00 00 00 00 00 00
00 00 00 00 00 00 32 12 01 01 01 32 01 01 01 01 01 32 01 01 01 01 01 32 00 00 00 00 00 00
00 00 00 00 00 00 32 12 01 01 01 32 01 01 01 01 01 32 01 01 01 01 01 32 00 00 00 00 00 00
32 32 32 32 32 32 32 32 32 32 32 32 32 33 33 33 32 32 01 01 01 01 01 32 32 32 32 32 32 32
32 01 01 06 01 06 01 01 01 01 01 02 02 01 01 01 02 02 01 01 01 01 01 32 01 01 16 16 01 32
32 01 01 06 01 06 01 01 01 01 01 03 03 02 01 02 03 02 01 01 01 01 01 32 01 01 10 16 01 32
32 18 01 06 01 06 01 01 01 01 01 02 04 03 02 02 03 02 01 01 01 01 01 36 01 01 10 16 21 32
32 01 01 06 01 06 01 01 01 01 01 02 03 04 03 03 04 01 01 01 01 01 01 32 01 01 16 16 10 32
32 01 01 06 01 06 01 01 01 01 01 02 03 03 02 02 02 01 01 01 01 01 01 32 01 01 16 16 10 32
32 32 32 32 32 32 32 01 01 01 01 01 02 02 02 01 01 01 01 01 01 01 01 32 32 32 32 32 32 32
00 00 00 00 00 00 32 01 01 01 01 01 01 01 01 01 01 01 01 01 01 01 01 32 00 00 00 00 00 00
00 00 00 00 00 00 32 01 01 01 01 01 01 01 01 01 01 01 01 01 01 01 01 32 00 00 00 00 00 00
00 00 00 00 00 00 32 32 32 32 37 32 32 32 33 33 32 32 01 01 01 01 01 32 32 32 32 32 32 32
00 00 00 00 00 00 32 01 01 01 01 01 01 01 01 01 01 32 01 01 01 01 01 32 01 01 06 01 01 32
00 00 00 00 00 00 32 10 16 16 16 01 01 01 01 01 01 32 01 01 01 01 01 32 01 01 06 01 01 32
00 00 00 00 00 00 32 10 16 16 16 10 01 01 01 01 01 33 01 01 01 01 01 39 01 01 06 01 01 32
00 00 00 00 00 00 32 01 16 16 01 10 01 01 01 01 01 33 01 01 01 01 01 32 01 01 06 01 01 32
00 00 00 00 00 00 32 18 16 10 16 16 01 01 01 01 01 32 01 01 01 01 01 32 01 01 06 01 34 32
00 00 00 00 00 00 32 32 32 32 32 32 32 32 32 32 32 32 32 32 32 32 32 32 32 32 32 32 32 32
04 00
01
07 25
08 06
01
16 01
07 07
01
28 14
08 07
05
01 14
11 06
11 07
11 08
11 09
11 10