36 21 01 1024
1 1 1 1 1 1 1 1 1 1 1
00 00 00 00 00 00 00 00 00 00 00 00 00 00 00 00 00 00 00 32 32 32 32 32 32 32 00 00 00 00 00 00 00 00 00 00
00 00 00 00 00 00 00 00 00 00 00 00 00 00 00 00 00 00 00 32 01 01 01 01 01 32 00 00 00 00 00 00 00 00 00 00
00 00 00 00 00 00 00 00 00 00 00 00 00 00 00 00 00 00 00 32 34 01 01 01 01 32 00 00 00 00 00 00 00 00 00 00
00 00 00 00 00 00 00 00 00 00 00 00 00 00 00 00 00 00 00 32 01 01 01 01 01 32 00 00 00 00 00 00 00 00 00 00
32 32 32 32 32 32 32 32 32 32 32 32 32 32 32 32 32 32 32 32 32 33 33 37 32 32 32 32 32 32 32 32 32 32 32 32
32 12 01 01 01 01 01 01 01 01 01 01 01 01 01 01 33 33 01 01 01 01 01 01 01 01 01 01 01 01 01 01 01 01 15 32
32 12 01 01 01 01 01 01 01 01 01 01 01 01 01 02 33 33 02 01 01 01 01 01 01 01 01 01 01 01 01 01 01 01 15 32
32 12 01 01 01 01 01 01 01 01 01 01 01 01 01 02 33 33 02 01 01 01 01 01 01 01 01 01 01 01 01 01 01 01 15 32
32 12 01 01 01 01 01 01 01 01 01 01 01 01 01 01 01 33 01 01 01 01 01 01 01 01 01 01 01 01 01 01 01 01 15 32
32 12 01 01 01 01 01 01 01 20 01 01 01 01 01 01 33 33 01 01 01 01 01 01 15 32 32 32 32 32 12 01 01 01 15 32
32 12 01 01 01 32 32 32 32 32 12 01 01 01 15 32 32 32 32 32 12 01 01 01 15 32 32 32 32 32 12 02 02 02 15 32
32 12 01 01 01 32 32 32 32 32 12 01 01 01 15 32 32 32 32 32 12 01 01 01 15 32 32 32 32 32 12 03 03 03 15 32
32 12 01 01 01 32 32 32 32 32 12 01 01 01 15 32 32 32 32 32 12 01 01 01 15 32 32 32 32 32 12 03 03 03 15 32
32 12 01 01 01 32 32 32 32 32 12 01 01 01 15 32 32 32 32 32 12 01 01 01 15 32 32 32 32 32 12 02 03 03 15 32
32 12 01 01 01 01 01 01 01 01 01 01 01 01 01 01 01 01 01 01 01 01 01 02 01 01 01 01 01 01 01 03 03 03 15 32
32 12 01 01 01 02 02 02 02 03 01 01 01 01 01 01 01 01 01 01 01 01 01 03 03 32 32 32 32 32 32 32 32 32 32 32
32 12 01 01 01 02 02 03 03 10 03 01 01 01 01 01 01 01 01 01 01 01 17 17 16 16 16 16 32 10 10 16 16 16 35 32
32 12 01 01 01 02 02 03 03 03 02 01 01 01 01 01 01 01 01 01 01 01 17 17 16 16 16 16 32 16 16 16 16 16 16 32
32 12 01 01 01 02 02 02 02 03 03 01 01 01 01 01 01 01 01 01 01 01 02 03 32 32 32 32 32 32 32 32 32 32 32 32
32 12 01 01 01 01 01 01 01 01 01 01 01 01 01 01 01 01 01 01 01 01 01 01 01 01 01 01 01 01 01 01 01 01 01 32
32 32 32 32 32 32 32 32 32 32 32 32 32 32 32 32 32 32 32 32 32 32 32 32 32 32 32 32 32 32 32 32 32 32 32 32
01 00
02
08 09
28 16
28 17