44 41
00 00 00 00 00 00 00 00 00 00 00 00 00 32 32 32 32 32 32 32 32 32 32 00 00 00 00 00 00 00 00 00 00 00 00 00 00 00 00 00 00 00 00 00
00 00 00 00 00 00 00 00 00 00 00 00 00 32 01 01 01 35 01 01 01 01 32 00 00 00 00 00 00 00 00 00 00 00 00 00 00 00 00 00 00 00 00 00
00 00 00 00 00 00 00 00 00 00 00 00 00 32 01 01 01 01 01 01 01 01 32 00 00 00 00 00 00 00 00 00 00 00 00 00 00 00 00 00 00 00 00 00
00 00 00 00 00 00 00 00 00 00 00 00 00 32 01 01 01 01 01 01 01 01 32 00 00 00 00 00 00 00 00 00 00 00 00 00 00 00 00 00 00 00 00 00
00 00 00 00 00 00 00 00 00 00 00 00 00 32 11 11 11 17 17 11 11 11 32 00 00 00 00 00 00 00 00 00 00 00 00 00 00 00 00 00 00 00 00 00
00 00 00 00 00 00 00 00 00 00 00 00 00 32 11 11 11 17 17 11 11 11 32 00 00 00 00 00 00 00 00 00 00 00 00 00 00 00 00 00 00 00 00 00
00 00 00 00 00 00 00 00 00 00 00 00 00 32 11 11 11 17 17 11 11 11 32 00 00 00 00 00 00 00 00 00 00 00 00 00 00 00 00 00 00 00 00 00
00 00 00 00 00 00 00 00 00 00 00 00 00 32 16 16 16 10 10 16 16 16 32 32 32 32 32 32 32 32 32 00 00 00 00 00 00 00 00 00 00 00 00 00
00 00 00 00 00 00 00 00 00 00 00 00 00 32 16 16 10 16 16 10 16 16 21 01 01 01 01 01 01 21 32 00 00 00 00 00 00 00 00 00 00 00 00 00
00 00 00 00 00 00 00 00 00 00 00 00 00 32 10 16 16 16 16 16 01 10 21 01 01 01 01 01 01 01 32 00 00 00 00 00 00 00 00 00 00 00 00 00
00 00 00 00 00 00 00 00 00 00 00 00 00 32 16 16 32 32 16 32 32 01 21 01 01 01 01 01 01 01 32 00 00 00 00 00 00 00 00 00 00 00 00 00
00 00 00 00 00 00 00 00 00 00 00 00 00 32 16 16 32 32 16 32 32 16 21 01 01 01 01 01 01 01 32 00 00 00 00 00 00 00 00 00 00 00 00 00
00 00 00 00 00 00 00 00 00 00 00 00 00 32 16 01 01 01 16 01 01 16 21 01 01 01 01 01 01 01 32 00 00 00 00 00 00 00 00 00 00 00 00 00
32 32 32 32 32 32 32 32 32 32 32 32 32 32 01 01 01 01 01 01 01 01 32 32 32 32 32 32 32 32 32 00 00 00 00 00 00 00 00 00 00 00 00 00
32 01 01 01 01 01 09 01 32 01 09 01 01 32 02 02 02 02 02 02 02 03 32 19 01 01 01 01 01 01 32 00 00 00 00 00 00 00 00 00 00 00 00 00
32 01 01 01 01 01 09 01 32 01 09 01 01 32 02 10 03 03 10 02 10 02 32 01 01 01 01 01 01 01 32 00 00 00 00 00 00 00 00 00 00 00 00 00
32 01 01 01 01 01 32 01 32 01 32 01 01 32 03 02 04 04 04 04 04 04 32 01 01 01 01 01 01 01 32 00 00 00 00 00 00 00 00 00 00 00 00 00
32 01 01 01 01 01 32 01 09 01 32 01 01 32 02 03 03 04 04 03 03 03 32 01 01 01 01 01 01 01 32 00 00 00 00 00 00 00 00 00 00 00 00 00
32 01 01 01 01 01 32 01 09 01 32 01 20 32 01 02 02 03 03 02 02 02 32 01 01 01 01 01 01 01 32 00 00 00 00 00 00 00 00 00 00 00 00 00
32 12 16 16 16 16 32 32 32 32 32 32 32 32 01 01 01 02 02 02 02 01 32 01 01 01 01 01 01 01 32 00 00 00 00 00 00 00 00 00 00 00 00 00
32 12 16 01 16 10 01 01 01 01 01 01 01 18 01 01 01 01 01 01 01 01 32 19 19 19 19 19 19 19 32 32 32 32 32 32 32 32 32 32 32 32 32 32
32 12 10 16 16 16 01 01 01 01 01 01 01 18 01 01 01 01 01 01 01 01 01 01 01 01 01 01 01 01 32 01 01 01 06 01 06 01 13 13 13 13 13 32
32 12 16 16 10 16 01 01 01 01 01 01 01 18 01 01 01 01 01 01 01 01 01 01 01 01 01 01 01 01 32 01 01 01 06 01 06 01 16 16 16 16 15 32
32 12 10 01 16 16 01 01 01 01 01 01 01 18 01 01 01 01 01 01 01 01 01 01 01 01 01 01 01 01 32 01 01 01 06 01 06 01 16 01 16 16 15 32
32 32 32 32 32 32 32 32 32 32 32 32 32 32 32 32 32 32 32 32 32 32 32 01 01 01 01 01 01 01 32 18 01 01 06 01 06 01 16 16 16 10 15 32
00 00 00 00 00 00 00 00 00 00 00 00 00 00 00 32 01 01 01 01 01 01 32 01 01 01 01 01 01 01 32 32 32 32 32 32 32 32 32 16 16 16 15 32
00 00 00 00 00 00 00 00 00 00 00 00 00 00 00 32 01 01 01 01 01 01 32 01 01 01 01 01 01 01 21 01 01 01 01 01 01 01 32 16 16 16 15 32
00 00 00 00 00 00 00 00 00 00 00 00 00 00 00 32 01 01 01 01 01 01 18 01 01 01 01 01 01 01 21 01 01 01 01 01 01 01 32 16 16 01 15 32
00 00 00 00 00 00 00 00 00 00 00 00 00 00 00 32 01 01 01 01 01 01 18 01 01 01 01 01 01 01 21 01 01 01 01 01 01 01 16 16 16 01 15 32
00 00 00 00 00 00 00 00 00 00 00 00 00 00 00 32 01 01 01 01 01 01 18 01 01 01 01 01 01 01 21 01 01 01 01 01 01 01 16 16 16 16 15 32
00 00 00 00 00 00 00 00 00 00 00 00 00 00 00 32 01 01 01 01 01 01 18 01 01 01 01 01 01 01 21 01 01 01 01 01 01 01 16 16 10 16 15 32
00 00 00 00 00 00 00 00 00 00 00 00 00 00 00 32 01 01 01 32 32 32 32 01 01 01 01 01 01 01 32 32 32 32 32 32 32 32 32 32 32 32 32 32
00 00 00 00 00 00 00 00 00 00 00 00 00 00 00 32 01 01 01 01 01 01 32 01 01 01 01 01 01 01 18 01 01 01 01 01 01 32 01 01 01 01 01 32
00 00 00 00 00 00 00 00 00 00 00 00 00 00 00 32 32 32 32 01 01 01 32 01 01 01 01 01 01 01 18 01 01 01 01 01 01 32 01 01 01 01 01 32
00 00 00 00 00 00 00 00 00 00 00 00 00 00 00 32 01 01 01 01 01 01 32 01 01 01 01 01 01 01 18 01 01 01 01 01 01 01 01 01 32 01 01 32
00 00 00 00 00 00 00 00 00 00 00 00 00 00 00 32 01 01 01 32 32 32 32 01 01 01 01 01 01 01 18 01 01 01 01 01 32 32 32 32 32 01 01 32
00 00 00 00 00 00 00 00 00 00 00 00 00 00 00 32 01 01 01 01 01 01 32 01 01 01 01 01 01 01 18 01 01 01 01 01 32 01 01 01 32 01 01 32
00 00 00 00 00 00 00 00 00 00 00 00 00 00 00 32 32 32 32 01 01 01 32 01 01 01 01 01 01 01 18 01 01 01 01 01 32 34 01 01 32 01 01 32
00 00 00 00 00 00 00 00 00 00 00 00 00 00 00 32 01 01 01 01 01 01 32 01 01 01 01 01 01 01 18 01 01 01 01 01 32 01 01 01 01 01 01 32
00 00 00 00 00 00 00 00 00 00 00 00 00 00 00 32 18 01 01 01 01 01 32 01 01 01 01 01 01 01 18 01 01 01 01 21 32 01 01 01 01 01 01 32
00 00 00 00 00 00 00 00 00 00 00 00 00 00 00 32 32 32 32 32 32 32 32 32 32 32 32 32 32 32 32 32 32 32 32 32 32 32 32 32 32 32 32 32