30 27 0 1024
1 1 1 1 1 1 1 1 1 1 1
00 00 00 00 00 00 00 00 00 00 00 00 00 00 00 00 00 00 00 00 00 00 00 00 00 00 00 00 00 00
00 00 00 00 00 00 00 00 00 00 00 00 12 16 10 01 19 00 00 00 00 00 00 00 00 00 00 00 00 00
00 00 00 00 00 00 00 00 00 00 00 00 12 01 16 16 16 00 00 00 00 00 00 00 00 00 00 00 00 00
00 00 00 00 00 00 00 00 00 00 00 00 12 16 16 10 10 00 00 00 00 00 00 00 00 00 00 00 00 00
00 00 00 00 00 00 00 00 00 00 00 00 12 16 16 16 16 00 00 00 00 00 00 00 00 00 00 00 00 00
00 00 00 00 00 00 00 00 00 00 00 00 12 16 16 16 16 00 00 00 00 00 00 00 00 00 00 00 00 00
00 00 00 00 00 00 00 35 11 11 13 00 12 16 16 16 16 00 01 01 01 01 01 00 00 00 00 00 00 00
00 00 00 00 00 00 00 11 11 11 01 00 12 01 16 16 01 39 01 01 01 01 01 00 00 00 00 00 00 00
00 00 00 00 00 00 00 11 11 11 01 00 12 16 16 16 16 00 01 01 01 01 01 00 00 00 00 00 00 00
00 00 00 00 00 00 00 12 01 01 01 00 12 16 16 16 16 00 01 01 01 01 01 00 00 00 00 00 00 00
00 00 00 00 00 00 00 12 01 01 01 00 12 16 16 16 16 00 01 01 01 01 01 00 00 00 00 00 00 00
00 00 00 00 00 00 00 00 00 00 00 00 00 33 33 33 00 00 01 01 01 01 01 00 00 00 00 00 00 00
00 01 01 06 01 06 01 01 01 01 01 02 02 01 01 01 02 02 01 01 01 01 01 00 01 01 16 16 01 00
00 01 01 06 01 06 01 01 01 01 01 03 03 02 01 02 03 02 01 01 01 01 01 00 01 01 10 16 01 00
00 18 01 06 01 06 01 01 01 01 01 02 04 03 02 02 03 02 01 01 01 01 01 36 01 01 10 16 21 00
00 01 01 06 01 06 01 01 01 01 01 02 03 04 03 03 04 01 01 01 01 01 01 00 01 01 16 16 10 00
00 01 01 06 01 06 01 01 01 01 01 02 03 03 02 02 02 01 01 01 01 01 01 00 01 01 16 16 10 00
00 00 00 00 00 00 00 01 01 01 01 01 02 02 02 01 01 01 01 01 01 01 01 00 00 00 00 00 00 00
00 00 00 00 00 00 00 01 01 01 01 01 01 01 01 01 01 01 01 01 01 01 01 00 00 00 00 00 00 00
00 00 00 00 00 00 00 01 01 01 01 01 01 01 01 01 01 01 01 01 01 01 01 00 00 00 00 00 00 00
00 00 00 00 00 00 00 00 00 00 37 00 00 00 33 33 00 00 01 01 01 01 01 00 00 00 00 00 00 00
00 00 00 00 00 00 00 01 01 01 01 01 01 01 01 01 01 00 01 01 01 01 01 00 01 01 06 01 01 00
00 00 00 00 00 00 00 10 16 16 16 01 01 01 01 01 01 00 01 01 01 01 01 00 01 01 06 01 01 00
00 00 00 00 00 00 00 10 16 16 16 10 01 01 01 01 01 33 01 01 01 01 01 39 01 01 06 01 01 00
00 00 00 00 00 00 00 01 16 16 01 10 01 01 01 01 01 33 01 01 01 01 01 00 01 01 06 01 01 00
00 00 00 00 00 00 00 18 16 10 16 16 01 01 01 01 01 00 01 01 01 01 01 00 01 01 06 01 34 00
00 00 00 00 00 00 00 00 00 00 00 00 00 00 00 00 00 00 00 00 00 00 00 00 00 00 00 00 00 00
04 00
03
07 25
07 07
08 07
08 06
05
28 14
07 08
08 08
09 08
09 07
09 06
05
01 14
11 06
11 07
11 08
11 09
11 10
05
16 01
12 06
12 07
12 08
12 09
12 10