29 39
00 00 00 00 00 00 00 00 00 00 00 32 32 32 32 32 32 32 00 00 00 00 00 00 00 00 00 00 00
00 00 00 00 00 00 00 00 00 00 00 32 01 01 01 01 35 32 00 00 00 00 00 00 00 00 00 00 00
00 00 00 00 00 00 00 00 00 00 00 32 01 01 01 01 01 32 00 00 00 00 00 00 00 00 00 00 00
00 00 00 00 00 00 00 00 00 00 00 32 11 11 11 11 11 32 00 00 00 00 00 00 00 00 00 00 00
00 00 00 00 00 00 00 00 00 00 00 32 11 11 11 11 11 32 00 00 00 00 00 00 00 00 00 00 00
00 00 00 00 00 00 00 00 00 00 00 32 11 11 11 11 11 32 00 00 00 00 00 00 00 00 00 00 00
00 00 00 00 00 00 00 00 00 00 00 32 01 01 10 01 01 32 00 00 00 00 00 00 00 00 00 00 00
00 00 00 00 00 00 00 00 00 00 00 32 01 01 01 01 01 32 00 00 00 00 00 00 00 00 00 00 00
00 00 00 00 00 00 00 00 00 00 00 32 01 01 01 01 01 32 00 00 00 00 00 00 00 00 00 00 00
00 00 00 00 00 00 00 00 00 00 00 32 01 01 01 01 01 32 00 00 00 00 00 00 00 00 00 00 00
32 32 32 32 32 32 32 32 32 32 32 32 32 32 32 01 01 32 32 32 32 32 32 32 32 32 32 32 32
32 01 01 01 32 01 01 01 01 01 01 32 01 01 01 01 01 32 01 01 01 01 01 01 01 01 01 01 32
32 01 01 01 32 01 01 01 01 01 01 32 01 01 32 32 32 32 01 01 01 01 01 01 01 01 01 01 32
32 01 01 01 32 01 01 01 01 01 01 32 01 01 01 01 01 33 01 01 01 01 01 01 01 01 01 01 32
32 01 01 01 01 01 32 01 01 01 01 32 32 32 32 01 01 32 11 11 11 11 32 01 01 01 01 01 32
32 32 32 32 01 01 32 01 01 01 01 32 01 01 01 01 01 32 01 01 01 01 32 01 01 32 32 32 32
32 01 01 01 01 01 32 01 01 20 01 32 01 01 32 32 32 32 20 01 01 01 32 01 01 01 01 01 32
32 01 01 01 32 32 32 32 33 32 32 32 01 01 01 01 01 32 32 32 32 32 32 32 32 01 01 01 32
32 01 01 01 01 01 01 09 01 09 01 09 32 32 32 01 01 01 32 01 01 01 32 01 01 01 01 01 32
32 01 01 01 01 01 01 09 01 09 01 09 01 01 01 01 01 01 32 01 01 01 32 01 01 32 01 01 32
32 01 01 01 01 32 01 09 01 09 01 09 01 01 01 01 01 01 01 01 32 01 01 01 01 32 01 01 32
32 01 01 01 01 32 01 09 01 09 01 09 01 01 01 01 01 01 01 01 32 01 01 01 01 32 01 01 32
32 32 32 32 32 32 32 32 33 32 32 32 01 01 01 01 01 32 32 32 32 32 32 33 32 32 32 32 32
00 00 32 01 02 02 02 02 02 02 01 32 01 01 01 01 01 32 10 01 16 16 16 01 01 01 32 00 00
00 00 32 01 02 03 03 04 03 02 02 32 01 01 01 01 01 32 01 16 16 16 16 01 01 01 32 00 00
00 00 32 01 02 03 32 04 04 03 03 32 01 01 01 01 01 32 16 16 16 16 32 01 01 01 32 00 00
00 00 32 01 02 02 32 04 03 02 02 33 01 01 01 01 01 33 16 16 16 10 32 01 01 01 32 00 00
00 00 32 01 02 02 32 01 01 20 01 32 01 01 01 01 01 32 10 16 20 01 32 01 01 01 32 00 00
00 00 32 01 01 01 32 32 32 32 32 32 01 01 01 01 01 32 32 32 32 32 32 01 01 01 32 00 00
00 00 32 01 01 01 01 01 01 01 01 01 01 01 01 01 01 01 01 01 01 01 01 01 01 01 32 00 00
00 00 32 01 01 01 01 01 01 01 01 01 01 01 01 01 01 01 01 01 01 01 01 01 01 01 32 00 00
00 00 32 01 01 01 01 01 01 01 01 01 01 01 01 01 01 01 01 01 01 01 01 01 01 01 32 00 00
00 00 32 01 01 01 01 01 01 01 01 01 01 01 01 01 01 01 01 01 01 01 01 01 01 01 32 00 00
00 00 32 32 32 32 32 32 32 32 32 32 32 32 38 32 32 32 32 32 32 32 32 32 32 32 32 00 00
00 00 00 00 00 00 00 00 00 00 00 32 01 01 01 01 01 32 00 00 00 00 00 00 00 00 00 00 00
00 00 00 00 00 00 00 00 00 00 00 32 01 01 01 01 01 32 00 00 00 00 00 00 00 00 00 00 00
00 00 00 00 00 00 00 00 00 00 00 32 01 01 01 01 01 32 00 00 00 00 00 00 00 00 00 00 00
00 00 00 00 00 00 00 00 00 00 00 32 34 01 01 01 01 32 00 00 00 00 00 00 00 00 00 00 00
00 00 00 00 00 00 00 00 00 00 00 32 32 32 32 32 32 32 00 00 00 00 00 00 00 00 00 00 00
04 00
05
09 27
12 03
13 03
14 03
15 03
16 03
05
18 16
12 04
13 04
14 04
15 04
16 04
05
20 27
12 05
13 05
14 05
15 05
16 05
04
09 16
18 14
19 14
20 14
21 14