19 15 0  150
1 1 1 1 1 1 1 1 1 1 1
00 00 00 00 00 00 00 00 00 00 00 00 00 00 00 00 00 00 00
00 00 00 01 01 01 14 16 00 00 00 00 00 00 00 00 00 00 00
00 00 00 01 00 15 15 16 00 00 00 00 00 00 00 00 00 00 00
00 00 00 01 00 14 15 16 00 00 00 00 00 00 00 00 00 00 00
00 00 00 14 01 01 01 12 14 14 14 02 01 01 14 01 00 00 00
00 11 16 16 16 16 16 01 12 10 01 03 00 15 15 01 00 00 00
00 00 00 00 01 00 00 12 12 00 14 04 00 15 15 01 00 00 00
00 00 00 00 20 12 13 12 12 12 13 04 00 15 15 01 00 00 00
00 00 00 00 00 00 15 12 12 15 15 03 00 01 15 01 00 00 00
00 00 00 00 00 00 15 07 33 00 14 02 00 00 15 01 00 00 00
00 00 00 00 00 00 01 01 01 01 01 01 00 00 15 01 00 00 00
00 00 00 00 00 00 01 13 13 13 13 01 12 14 01 16 11 00 00
00 00 00 00 00 00 00 00 00 00 00 01 12 01 11 01 32 35 00
00 00 00 00 00 00 00 00 00 00 00 34 00 00 00 00 00 00 00
00 00 00 00 00 00 00 00 00 00 00 00 00 00 00 00 00 00 00
01 00
01
04 07
16 12