15 15 0 1024
1 1 1 1 1 1 1 1 1 1 1
00 00 00 00 00 00 00 00 00 00 00 00 00 00 00
00 35 32 01 01 01 01 00 00 00 00 00 00 00 00
00 00 00 00 00 00 01 29 29 32 01 01 01 21 00
00 00 00 01 01 01 01 01 01 00 00 00 00 00 00
00 00 00 01 25 01 02 03 04 03 02 01 01 24 00
00 00 00 11 01 01 01 19 17 01 01 01 06 07 00
00 00 00 01 01 11 02 03 04 03 02 07 17 07 00
00 00 00 16 13 01 11 17 10 17 11 07 06 06 00
00 00 00 16 29 17 01 17 04 07 06 07 00 00 00
00 00 00 16 29 00 33 00 03 01 00 07 00 01 00
00 00 00 16 29 00 33 00 02 01 00 07 00 01 00
00 00 00 01 01 01 01 01 01 01 01 01 01 01 00
00 00 00 00 00 00 00 00 37 00 00 00 00 00 00
00 00 00 00 00 00 00 00 34 00 00 00 00 00 00
00 00 00 00 00 00 00 00 00 00 00 00 00 00 00
02 00
02
07 05
09 02
13 02
02 01