20 17 01 120
1 1 1 1 1 1 1 1 1 1 1
32 32 32 32 32 32 32 32 32 32 32 32 32 32 32 32 32 32 32 32
32 01 01 01 01 35 32 32 32 00 00 00 00 00 00 00 00 00 00 32
32 10 00 00 00 00 00 00 32 34 01 01 01 00 00 00 00 00 00 32
32 10 00 00 00 00 00 00 32 01 00 00 01 00 00 00 00 00 00 32
32 01 00 00 00 00 00 00 32 01 00 00 01 00 00 00 00 00 00 32
32 01 00 00 00 00 00 00 32 01 01 01 01 01 01 01 01 10 01 32
32 01 00 00 00 00 00 00 32 33 32 32 32 32 32 32 32 32 01 32
32 01 00 00 00 00 00 00 32 01 00 00 00 00 00 00 00 32 01 32
32 01 00 00 00 00 00 00 32 01 00 00 00 00 00 00 00 32 01 32
32 01 01 01 01 01 10 01 33 01 01 01 01 00 00 00 00 32 01 32
32 01 00 00 00 01 00 00 00 32 32 32 33 32 32 32 32 32 11 32
32 01 00 00 00 01 00 00 00 00 00 00 01 32 32 32 32 32 01 32
32 01 00 00 00 01 00 00 00 00 00 00 01 01 01 01 01 01 01 32
32 01 00 00 00 11 00 00 00 00 00 00 00 00 01 00 00 00 01 32
32 01 00 00 00 11 00 00 00 00 00 00 00 00 01 00 00 00 01 32
32 01 01 01 01 01 01 01 01 01 01 01 01 01 01 01 01 01 01 32
32 32 32 32 32 32 32 32 32 32 32 32 32 32 32 32 32 32 32 32
00 00