11 13 0  128
1 1 1 1 1 0 1 1 1 1 1
35 32 11 11 11 11 11 11 03 11 11
11 16 11 16 01 16 16 16 16 01 11
03 16 01 11 16 16 16 16 16 01 11
01 16 16 16 01 03 11 11 16 01 11
07 11 11 16 25 01 03 16 13 01 11
01 16 01 11 11 01 01 11 16 07 01
10 11 11 11 19 11 01 11 16 01 01
01 11 11 11 01 01 01 11 16 01 01
10 03 03 03 03 03 03 03 33 07 10
01 01 01 01 01 01 01 01 01 01 01
01 01 01 01 01 01 01 01 01 01 01
00 00 00 00 00 01 00 00 00 00 00
00 00 00 00 00 34 00 00 00 00 00
01 00
01
04 06
01 00