15 14 0  1024
1 1 1 1 1 1 1 1 1 1 1
11 01 10 01 16 16 16 16 16 24 16 00 11 11 11
01 16 16 16 16 16 16 16 00 16 16 00 10 11 11
16 16 16 16 00 25 16 16 16 16 16 01 10 10 11
16 00 16 16 13 13 13 13 13 16 10 01 13 01 21
16 00 16 16 01 16 16 16 16 16 00 15 12 00 33
01 16 16 15 32 00 10 00 00 00 01 15 12 00 01
18 00 00 11 35 32 01 01 01 01 01 13 01 01 01
12 14 06 01 32 00 01 00 00 13 13 13 13 13 00
33 12 13 01 01 00 01 01 01 01 13 13 13 01 15
01 14 00 00 01 01 15 10 00 14 11 00 00 00 00
01 12 13 15 01 00 00 17 00 12 12 00 00 00 00
01 01 00 15 01 01 01 01 14 15 01 00 00 00 00
00 01 11 10 38 00 00 01 12 12 01 00 00 00 00
00 00 00 00 34 00 00 00 00 00 00 00 00 00 00
02 00
01
00 06
05 06
01
14 03
04 05