21 08 03 1024
1 1 1 1 1 1 1 1 1 1 1
00 00 00 00 00 00 00 00 00 00 00 00 00 00 00 00 00 00 00 00 00
00 01 11 01 01 00 00 11 01 11 01 11 01 01 01 11 01 01 01 34 00
00 01 11 11 11 11 11 11 11 11 11 11 11 11 11 11 11 33 00 00 00
00 11 11 11 01 11 11 01 01 01 11 11 11 11 11 01 01 00 00 00 00
00 01 01 33 01 11 11 01 11 11 01 01 01 01 01 01 01 01 00 00 00
00 35 11 11 01 01 01 01 11 11 33 00 00 00 00 00 00 00 00 00 00
00 01 33 01 01 01 01 01 01 01 01 00 00 00 00 00 00 00 00 00 00
00 00 00 00 00 00 00 00 00 00 00 00 00 00 00 00 00 00 00 00 00
00 00