19 06 03 82
1 1 1 1 1 0 0 1 0 1 1
01 11 01 01 00 00 11 01 11 01 11 01 01 01 11 01 01 01 34
01 11 11 11 11 11 11 11 11 11 11 11 11 11 11 11 33 00 00
11 11 11 01 11 11 01 01 01 11 11 11 11 11 01 01 00 00 00
01 01 33 01 11 11 01 11 11 01 01 01 01 01 01 01 01 00 00
35 11 11 01 01 01 01 11 11 33 00 00 00 00 00 00 00 00 00
01 33 01 01 01 01 01 01 01 01 00 00 00 00 00 00 00 00 00
00 00