35 35 00 1024
1 1 1 1 1 1 1 1 1 1 1
00 00 00 00 00 00 00 00 00 00 00 00 03 03 03 03 03 03 03 03 03 03 03 00 00 00 00 00 00 00 00 00 00 00 00
00 00 00 00 00 00 00 00 00 00 00 00 03 10 01 01 01 01 10 10 10 22 03 00 00 00 00 00 00 00 00 00 00 00 00
00 00 00 00 00 00 00 00 00 00 00 00 03 10 01 10 01 10 01 01 01 24 03 00 00 00 00 00 00 00 00 00 00 00 00
00 00 00 00 00 00 00 00 00 00 00 00 03 10 01 10 01 10 10 10 01 10 03 00 00 00 00 00 00 00 00 00 00 00 00
00 00 00 00 00 00 00 00 00 00 00 00 03 01 01 10 01 01 10 10 01 10 03 00 00 00 00 00 00 00 00 00 00 00 00
00 00 00 00 00 00 00 00 00 00 00 00 03 10 01 01 10 01 10 01 01 40 03 00 00 00 00 00 00 00 00 00 00 00 00
00 00 00 00 00 00 00 00 00 00 00 00 03 10 01 10 10 01 10 01 10 10 03 00 00 00 00 00 00 00 00 00 00 00 00
00 00 00 00 00 00 00 00 00 00 00 00 03 01 01 01 10 01 01 01 10 10 03 00 00 00 00 00 00 00 00 00 00 00 00
00 00 00 00 00 00 00 00 00 00 00 00 03 01 10 01 01 10 10 01 01 01 03 00 00 00 00 00 00 00 00 00 00 00 00
00 00 00 00 00 00 00 00 00 00 00 00 03 01 10 10 01 01 01 10 10 10 03 00 00 00 00 00 00 00 00 00 00 00 00
00 00 00 00 00 00 00 00 00 00 00 00 03 03 03 03 03 03 03 03 03 03 03 00 00 00 00 00 00 00 00 00 00 00 00
00 00 00 00 00 00 00 00 00 00 00 00 00 00 00 00 00 00 00 00 00 00 00 00 00 00 00 00 00 00 00 00 00 00 00
03 03 03 03 03 03 03 03 03 03 03 00 03 03 03 03 03 03 03 03 03 03 03 00 03 03 03 03 03 03 03 03 03 03 03
03 11 13 13 13 13 13 13 32 01 03 00 03 40 01 01 01 01 01 01 01 01 03 00 03 17 01 01 01 17 01 24 01 22 03
03 12 16 16 16 16 16 16 32 01 03 00 03 32 32 32 32 32 32 32 32 01 03 00 03 17 17 01 17 17 01 17 01 40 03
03 12 16 10 16 16 16 16 32 01 03 00 03 01 01 01 01 01 32 27 32 01 03 00 03 01 01 01 01 17 01 17 17 17 03
03 12 16 16 16 16 16 16 01 16 03 00 03 32 32 32 32 32 32 32 32 01 03 00 03 01 00 01 00 17 01 01 17 17 03
03 12 01 16 16 16 01 10 16 16 03 00 03 01 01 01 01 01 32 18 32 01 03 00 03 01 17 01 00 17 17 01 00 17 03
03 12 16 10 16 10 16 16 16 16 03 00 03 32 32 32 32 01 32 01 32 01 03 00 03 01 00 01 01 01 17 01 01 17 03
03 12 16 16 16 16 16 16 16 16 03 00 03 01 01 01 32 01 32 01 32 01 03 00 03 01 01 17 17 01 00 00 01 00 03
03 12 16 16 10 10 01 16 01 01 03 00 03 32 32 01 32 01 32 01 32 01 03 00 03 17 01 17 17 01 01 01 01 17 03
03 22 01 16 40 10 16 16 10 01 03 00 03 35 32 01 32 01 32 01 32 01 03 00 03 01 01 17 17 17 17 00 17 17 03
03 03 03 03 03 03 03 03 03 03 03 00 03 03 03 03 03 03 03 03 03 03 03 00 03 03 03 03 03 03 03 03 03 03 03
00 00 00 00 00 00 00 00 00 00 00 00 00 00 00 00 00 00 00 00 00 00 00 00 00 00 00 00 00 00 00 00 00 00 00
00 00 00 00 00 00 00 00 00 00 00 00 03 03 03 03 03 03 03 03 03 03 03 00 00 00 00 00 00 00 00 00 00 00 00
00 00 00 00 00 00 00 00 00 00 00 00 03 11 40 11 11 11 01 12 01 01 03 00 00 00 00 00 00 00 00 00 00 00 00
00 00 00 00 00 00 00 00 00 00 00 00 03 11 01 01 01 01 01 12 01 01 03 00 00 00 00 00 00 00 00 00 00 00 00
00 00 00 00 00 00 00 00 00 00 00 00 03 11 11 11 01 12 01 01 01 11 03 00 00 00 00 00 00 00 00 00 00 00 00
00 00 00 00 00 00 00 00 00 00 00 00 03 11 01 01 01 11 14 14 11 11 03 00 00 00 00 00 03 03 03 03 03 03 03
00 00 00 00 00 00 00 00 00 00 00 00 03 11 14 12 01 01 01 01 11 11 03 00 00 00 00 00 03 40 01 01 01 40 03
00 00 00 00 00 00 00 00 00 00 00 00 03 11 11 11 14 11 01 11 11 11 03 00 00 00 00 00 03 01 01 40 01 01 03
00 00 00 00 00 00 00 00 00 00 00 00 03 11 01 01 01 12 01 01 01 01 03 00 00 00 00 00 03 01 01 01 01 01 03
00 00 00 00 00 00 00 00 00 00 00 00 03 11 01 11 01 01 01 11 26 11 03 00 00 00 00 00 03 01 01 34 01 01 03
00 00 00 00 00 00 00 00 00 00 00 00 03 22 01 11 11 11 11 11 11 11 03 00 00 00 00 00 03 40 01 01 01 40 03
00 00 00 00 00 00 00 00 00 00 00 00 03 03 03 03 03 03 03 03 03 03 03 00 00 00 00 00 03 03 03 03 03 03 03
05 10
09     
01 21
13 14  
14 14
15 14
16 14
17 14
18 14
18 15
19 14
13 21
04
21 01
13 20
14 20
14 21
13 21
10
13 33
20 14
20 15
20 16
19 16
20 17
20 18
20 19
20 20
20 21
13 21
12
19 17
13 16
14 16
15 16
16 16
17 16
18 16
18 17
18 18
18 19
18 20
18 21
13 21
07
33 13
13 18
14 18
15 18
16 18
16 19
16 20
16 21
29 29
13 09
33 29
09 13
29 33
21 25
33 33
25 21
31 30
21 13
33 14
31 31
21 05
31 31
13 13
31 31
14 25
31 31
04 21
31 31