33 33 00 1024
1 1 1 1 1 1 1 1 1 1 1
00 00 00 00 00 00 00 00 00 00 00 00 10 01 01 01 01 10 10 10 22 00 00 00 00 00 00 00 00 00 00 00 00
00 00 00 00 00 00 00 00 00 00 00 00 10 01 10 01 10 01 01 01 01 00 00 00 00 00 00 00 00 00 00 00 00
00 00 00 00 00 00 00 00 00 00 00 00 10 01 10 01 10 10 10 01 10 00 00 00 00 00 00 00 00 00 00 00 00
00 00 00 00 00 00 00 00 00 00 00 00 01 01 10 01 01 10 10 01 10 00 00 00 00 00 00 00 00 00 00 00 00
00 00 00 00 00 00 00 00 00 00 00 00 10 01 01 10 01 10 01 01 40 00 00 00 00 00 00 00 00 00 00 00 00
00 00 00 00 00 00 00 00 00 00 00 00 10 01 10 10 01 10 01 10 10 00 00 00 00 00 00 00 00 00 00 00 00
00 00 00 00 00 00 00 00 00 00 00 00 01 01 01 10 01 01 01 10 10 00 00 00 00 00 00 00 00 00 00 00 00
00 00 00 00 00 00 00 00 00 00 00 00 01 10 01 01 10 10 01 01 01 00 00 00 00 00 00 00 00 00 00 00 00
00 00 00 00 00 00 00 00 00 00 00 00 01 10 10 01 01 01 10 10 10 00 00 00 00 00 00 00 00 00 00 00 00
00 00 00 00 00 00 00 00 00 00 00 00 00 00 00 00 00 00 00 00 00 00 00 00 00 00 00 00 00 00 00 00 00
00 00 00 00 00 00 00 00 00 00 00 00 00 00 00 00 00 00 00 00 00 00 00 00 00 00 00 00 00 00 00 00 00
00 00 00 00 00 00 00 00 00 00 00 00 00 00 00 00 00 00 00 00 00 00 00 00 00 00 00 00 00 00 00 00 00
11 13 13 13 13 13 13 13 01 00 00 00 40 01 01 01 01 01 01 01 01 00 00 00 17 01 01 01 17 01 01 01 22
12 16 16 16 16 16 16 32 01 00 00 00 32 32 32 32 32 32 32 32 01 00 00 00 17 17 01 17 17 01 17 01 40
12 16 10 16 16 16 16 32 01 00 00 00 01 01 01 01 01 01 01 32 01 00 00 00 01 01 01 01 17 01 17 17 17
12 16 16 16 16 16 16 01 16 00 00 00 32 32 32 32 32 32 01 32 01 00 00 00 01 00 01 00 17 01 01 17 17
12 01 16 16 16 01 10 16 16 00 00 00 01 01 01 01 01 32 01 32 01 00 00 00 01 17 01 00 17 17 01 00 17
12 16 10 16 10 16 16 16 16 00 00 00 32 32 32 32 01 32 01 32 01 00 00 00 01 00 01 01 01 17 01 01 17
12 16 16 16 16 16 16 16 16 00 00 00 01 01 01 32 01 32 01 32 01 00 00 00 01 01 17 17 01 00 00 01 00
12 16 16 16 10 01 16 01 01 00 00 00 32 32 01 32 01 32 01 32 01 00 00 00 17 01 17 17 01 01 01 01 17
22 01 16 40 10 16 16 10 01 00 00 00 35 32 01 32 01 32 01 32 01 00 00 00 01 01 17 17 17 17 00 17 17
00 00 00 00 00 00 00 00 00 00 00 00 00 00 00 00 00 00 00 00 00 00 00 00 00 00 00 00 00 00 00 00 00
00 00 00 00 00 00 00 00 00 00 00 00 00 00 00 00 00 00 00 00 00 00 00 00 00 00 00 00 00 00 00 00 00
00 00 00 00 00 00 00 00 00 00 00 00 00 00 00 00 00 00 00 00 00 00 00 00 00 00 00 00 00 00 00 00 00
00 00 00 00 00 00 00 00 00 00 00 00 11 40 11 11 11 01 12 01 01 00 00 00 00 00 00 00 00 00 00 00 00
00 00 00 00 00 00 00 00 00 00 00 00 11 01 01 01 01 01 12 01 01 00 00 00 00 00 00 00 00 00 00 00 00
00 00 00 00 00 00 00 00 00 00 00 00 11 11 11 01 12 01 01 01 11 00 00 00 00 00 00 00 00 00 00 00 00
00 00 00 00 00 00 00 00 00 00 00 00 11 01 01 01 11 14 14 11 11 00 00 00 00 00 00 00 00 00 00 00 00
00 00 00 00 00 00 00 00 00 00 00 00 11 14 12 01 01 01 01 11 11 00 00 00 00 00 00 00 40 01 01 01 40
00 00 00 00 00 00 00 00 00 00 00 00 11 11 11 14 11 01 11 11 11 00 00 00 00 00 00 00 01 01 40 01 01
00 00 00 00 00 00 00 00 00 00 00 00 11 01 01 01 12 01 01 01 01 00 00 00 00 00 00 00 01 01 27 01 01
00 00 00 00 00 00 00 00 00 00 00 00 11 01 11 01 01 01 11 01 11 00 00 00 00 00 00 00 01 01 34 01 01
00 00 00 00 00 00 00 00 00 00 00 00 22 01 11 11 11 11 11 11 11 00 00 00 00 00 00 00 40 01 01 01 40
05 11
11  
00 20
12 15
13 15
14 15
15 15
16 15
17 15
17 16
17 17
17 18
17 19
17 20
03
20 00
12 19
13 19
13 20
17
12 32
19 13
19 14
19 15
18 15
19 16
19 17
19 18
19 19
19 20
12 13
13 13
14 13
15 13
16 13
17 13
17 14
18 13
11
18 16
12 15
13 15
14 15
15 15
16 15
17 15
17 16
17 17
17 18
17 19
17 20
07
32 12
12 17
13 17
14 17
15 17
15 18
15 19
15 20
28 28
12 08
32 28
08 12
28 32
20 24
32 32
24 20
30 29
20 12
32 13
30 30
30 04
30 30
12 12
30 30
13 24
30 30
03 20
30 30
20 04
30 30