27 37 0 212
1 1 1 1 1 1 1 1 1 1 1
00 00 00 00 00 00 00 00 00 00 00 01 01 01 01 35 00 00 00 00 00 00 00 00 00 00 00
00 00 00 00 00 00 00 00 00 00 00 01 01 01 01 01 00 00 00 00 00 00 00 00 00 00 00
00 00 00 00 00 00 00 00 00 00 00 11 11 11 11 11 00 00 00 00 00 00 00 00 00 00 00
00 00 00 00 00 00 00 00 00 00 00 11 11 11 11 11 00 00 00 00 00 00 00 00 00 00 00
00 00 00 00 00 00 00 00 00 00 00 11 11 11 11 11 00 00 00 00 00 00 00 00 00 00 00
00 00 00 00 00 00 00 00 00 00 00 01 01 10 01 01 00 00 00 00 00 00 00 00 00 00 00
00 00 00 00 00 00 00 00 00 00 00 01 01 01 01 01 00 00 00 00 00 00 00 00 00 00 00
00 00 00 00 00 00 00 00 00 00 00 01 01 01 01 01 00 00 00 00 00 00 00 00 00 00 00
00 00 00 00 00 00 00 00 00 00 00 01 01 01 01 01 00 00 00 00 00 00 00 00 00 00 00
00 00 00 00 00 00 00 00 00 00 00 00 00 00 01 01 00 00 00 00 00 00 00 00 00 00 00
01 01 01 00 01 01 01 01 01 01 00 01 01 01 01 01 00 01 01 01 01 01 01 01 01 01 01
01 01 01 00 01 01 01 01 01 01 00 01 01 00 00 00 00 01 01 01 01 01 01 01 01 01 01
01 01 01 00 01 01 01 01 01 01 00 01 01 01 01 01 33 01 01 01 01 01 01 01 01 01 01
01 01 01 01 01 00 01 01 01 01 00 00 00 00 01 01 00 32 32 32 32 00 01 01 01 01 01
00 00 00 01 01 00 01 01 01 01 00 01 01 01 01 01 00 01 01 01 01 00 01 01 00 00 00
01 01 01 01 01 00 01 01 20 01 00 01 01 00 00 00 00 20 01 01 01 00 01 01 01 01 01
01 01 01 00 00 00 00 33 00 00 00 01 01 01 01 01 00 00 00 00 00 00 00 00 01 01 01
01 01 01 01 01 01 32 01 11 01 10 00 00 00 01 01 01 00 01 01 01 00 01 01 01 01 01
01 01 01 01 01 01 32 01 11 01 10 01 01 01 01 01 01 00 01 01 01 00 01 01 00 01 01
01 01 01 01 00 01 32 01 11 01 10 01 01 01 27 01 01 01 01 00 01 01 01 01 00 01 01
01 01 01 01 00 01 32 01 11 01 10 01 01 01 01 01 01 01 01 00 01 01 01 01 00 01 01
00 00 00 00 00 00 00 33 00 00 00 01 01 01 01 01 00 00 00 00 00 00 33 00 00 00 00
00 00 01 02 02 02 02 02 02 01 00 01 01 01 01 01 00 10 01 16 16 16 01 01 01 00 00
00 00 01 02 03 03 04 03 02 02 00 01 01 01 01 01 00 01 16 16 16 16 01 01 01 00 00
00 00 01 02 03 00 04 04 03 03 00 01 01 01 01 01 00 16 16 16 16 00 01 01 01 00 00
00 00 01 02 02 00 04 03 02 02 33 01 01 01 01 01 33 16 16 01 10 00 01 01 01 00 00
00 00 01 02 02 00 01 01 20 01 00 01 01 01 01 01 00 10 16 20 01 00 01 01 01 00 00
00 00 01 01 01 00 00 00 00 00 00 01 01 01 01 01 00 00 00 00 00 00 01 01 01 00 00
00 00 01 01 01 01 01 01 01 01 01 01 01 01 01 01 01 01 01 01 01 01 01 01 01 00 00
00 00 01 01 01 01 01 01 01 01 01 01 01 01 01 01 01 01 01 01 01 01 01 01 01 00 00
00 00 01 01 01 01 01 01 01 01 01 01 01 01 01 01 01 01 01 01 01 01 01 01 01 00 00
00 00 01 01 01 01 01 01 01 01 01 01 01 01 01 01 01 01 01 01 01 01 01 01 01 00 00
00 00 00 00 00 00 00 00 00 00 00 00 00 38 00 00 00 00 00 00 00 00 00 00 00 00 00
00 00 00 00 00 00 00 00 00 00 00 01 01 01 01 01 00 00 00 00 00 00 00 00 00 00 00
00 00 00 00 00 00 00 00 00 00 00 01 01 01 01 01 00 00 00 00 00 00 00 00 00 00 00
00 00 00 00 00 00 00 00 00 00 00 01 01 01 01 01 00 00 00 00 00 00 00 00 00 00 00
00 00 00 00 00 00 00 00 00 00 00 01 01 34 01 01 00 00 00 00 00 00 00 00 00 00 00
04 00
05
08 26
11 02
12 02
13 02
14 02
15 02
06
17 15
11 03
12 03
13 03
14 03
15 03
15 00
05
19 26
11 04
12 04
13 04
14 04
15 04
09
08 15
17 13
18 13
19 13
20 13
06 17
06 18
06 19
15 00
06 20